Somebody to Love	A Day At The Races
White Man	A Day At The Races
Good Old-Fashioned Lover Boy	A Day At The Races
A Kind of Magic	A Kind Of Magic
Friends Will Be Friends	A Kind Of Magic
One Year of Love	A Kind Of Magic
Who Wants to Live Forever	A Kind Of Magic
Princes of the Universe	A Kind Of Magic
39	A Night At The Opera
Bohemian Rhapsody	A Night At The Opera
Love of My Life	A Night At The Opera
You're My Best Friend	A Night At The Opera
Death On Two Legs	A Night At The Opera
Under Pressure	Hot Space
All God's People	Innuendo
Bijou	Innuendo
Don't Try So Hard	Innuendo
Headlong	Innuendo
I Can't Live With You	Innuendo
I'm Going Slightly Mad	Innuendo
Innuendo	Innuendo
The Show Must Go On	Innuendo
These Are the Days of Our Lives	Innuendo
Bicycle Race	Jazz
Don't Stop Me Now	Jazz
Fat Bottomed Girls	Jazz
Fun It	Jazz
In Only Seven Days	Jazz
Heaven for Everyone	Made In Heaven
I Was Born to Love You	Made In Heaven
Made in Heaven	Made In Heaven
Mother Love	Made In Heaven
My Life Has Been Saved	Made In Heaven
Too Much Love Will Kill You	Made In Heaven
You Don't Fool Me	Made In Heaven
My Melancholy Blues	News Of The World
Spread Your Wings	News Of The World
We Are The Champions	News Of The World
We Will Rock You	News Of The World
Living on My Own	NOT FOUND
The Great Pretender	NOT FOUND
Doing Alright	Queen
Keep Yourself Alive	Queen
Seven Seas of Rhye	Queen
Son and Daughter	Queen
Nevermore	Queen II
Father to Son	Queen II
Procession	Queen II
Now I'm Here	Sheer Heart Attack
Killer Queen	Sheer Heart Attack
Another One Bites The Dust	The Game
Crazy Little Thing Called Love	The Game
Play the Game	The Game
Save Me	The Game
I Want It All	The Miracle
Rain Must Fall	The Miracle
Scandal	The Miracle
The Invisible Man	The Miracle
The Miracle	The Miracle
Hammer to Fall	The Works
I Want to Break Free	The Works
It's a Hard Life	The Works
Radio Ga Ga	The Works